"que vontade de cagar, mas mo pregui√ßa de me limpar"	tonho	
"Desde que eu era crian√ßa o Bruno Mars √© o unico cara que eu olho e falo, cacete √© um cara"	lavinia	
"Pode botar, gigio"	lavinia	
"Vou almo√ßar agora (16:34)"	gabriel	
"Que vontade de vomitar um bezerro"	tonho	
"N√£o, eu fico chupando e depois engulo"	lavinia	
"Vai, toca ai uma"	lavinia	
"Queria aprender aquele com os 2 dedoss na boca"	tonho	
"E ai os italianos fizeram as armas de pizza"	gabriel	
"Agn√≥stico √© o cara que bota e tira"	gabriel	
"morreu, mamando"	gabriel	
"O pau dele balan√ßou e ai eu olhei e pensei, ibama liberou andar com cobra foi?"	ivan	
"Aquela porra era mole"	ivan	
"Eu nunca assisti Guardi√µes da Gal√°xia mas eu sei que o Darth Vader √© o pai do Luke..."	lavinia	
"Lav√≠nia ganhou um kit da felicidade, um a√ßa√≠ e um cu"	antony	
"cala a boca e balan√ßa os peito"	antony	
"pior que to com vontade de colocar na boca"	tonho	
"claro po, ninguem liga pra alejado"	ivan	
"vamos ficar molinho juntos"	gabriel	
"se eu vejo um careca... eu corro vei"	antony	
Antony: "po vei, presto mais aten√ßao na cama do q na cena em si, deve ser mo confortavel"
 ????: "voc√™ e baiano √© antony?"	lavinia	
Tonho: "Nova temporada de sex education uhuuu. Mais Sexo!" ????: "Mas √© vei eu gosto dessas  coisas"	lavinia	
"√© massa quando eles tiram a roupa"	lavinia	
"creck creck, o barulho da minha pica no seu cu"	ivan	
"bate na minha bunda leozin"	gabriel	
"Ixquece, papai"	lalic	
"Seu cu"	gigio	
"Ser vegano √© mais caro do que ser... (minuto de sil√™ncio) ... Normal"	antony	
"Falando em fumar menta..."	lavinia	
"baiano √© muito burro"	gabriel	
"lavina, toca uma pra mim"	tonho	
"caralho olha essa xota"	tonho	
"ou fui chegar na escola e me despedi com um beijo e o uber achou estranho"	tonho	
"voce s√≥ quer usar"	gabriel	
Antony: "por que as crian√ßas ficam s√≥ me encarando?" ????: "porque vc √© quase careca"	lavinia	
"eita olho de papoco da p√© seu, Lav√≠nia"	gabriel	
"que merda, tava co√ßando o saco..." 
 "e ainda ta co√ßando"	tonho	
"um bebezinho tava apontando pra Matheus e chamando de papai, achei suspeito"	gabriel	
"Meu sonho √© espancar um b√™bado"	gigio	
"pra vc vir de boca aberta"	gigio	
"gabriel ia me dar o cu"	lavinia	
"Escutaram o cabrunco?"	antony	
"√â o carro da rua passando no seu ovo"	gabriel	
"Vou botar pica. HMMM"	tonho	
"toquei muito ontem"	gabriel	
Gabriel: "Vamo passar o Natal com o aniversariante?" Tonho: "kkkkkkk bora" ????: "Que? n√£o entendi, quem?" Tonho: "Gabriel chamou nois pra passar o Natal com o aniversariante po, quem nasceu no Natal?" ????: "Ahh kkkkkkkk √© pq eu achei que era *uma pessoa de verdade*"	antony	
"essa veia do krl so quer nosso dinheiro"	gabriel	
Antony: "eu vou precisar ir pra uma festa at√© a noite" ????: "√© s√≥ queimar o aniversariante" Antony: "√© uma prima minha de 6 anos, velho" ????: "melhor, gasta menos gasolina"	lalic	
" Ei, crack √© osso n√©"	lavinia	
"Achei que voc√™ fosse profissional em pular na bola, Lalic"	gabriel	
" chup-chup √© mt bom"	gabriel	
" Que dan√ßar o que, no s√£o jo√£o eu tava era comendo..."	lavinia	
Tonho:"muri√ßoca do meu saco" ????: "do seu n√£o, do nosso"
 Tonho: "saco comunista"	lavinia	
Tonho: "O cara ta pedindo conta da netflix emprestada mano wtf" ????: "Que POBRE"	gabriel	
"J√° estou literalmente aberto"	tonho	
Tonho: "E ai po, t√° com o pavio curto √©?"
 ????: "MEU PINTO √â CURTO!"	tonho	
"Vei, acho que n√≥s n√£o estranharemos...estranhariaremos... ah sla fodase"	gabriel	
"Voc√™s fariam parte de uma rela√ß√£o aberta?"	leozinho	
"Gaia consciente"	tonho	
"o certo √© as empresas serem veganas e a gente normal n√©"	tonho	
"no dia que lan√ßou 2021 eu tava no shopping"	gabriel	
Lavinia:"N√£o pode arrancar o dedo dos amiguinhos, n√£o" ????: "Oxen, claro que pode. Pq vc acha que Lula tem um dedo s√≥? Ele era companheiro"	gabriel	
????: "Eu sou ambidestra pra uma coisa s√≥..." Tonho: "RUM"	lavinia	
Lav√≠nia: "Caralho, essa mulher tem um f√≠sico que eu queria ter" ????: "Quando vai ver a mulher t√° casada com um f√≠sico"	tonho	
‚Äúeu odeio o harry styles que cara imbecil velho‚Äù	gabriel	
"Eu tenho amigo que √© coach de pinto"	ivan	
‚Äúeu n√£o queria ser assim (homof√≥bica)‚Äù	lavinia
????: "Pra eu colocar os p√©s na mesa √© muito malabarismo mofio" Tonho: "Tbm mofio vc √© todo truncadinho" ????: "Truncadinho √© seu CU"	antony	
????: "Da muito trabalho po, √© muito grossa ai demora demais" Tonho: "Foi o que ela disse" ????: "Pior que √© verdade"	lavinia	
Lav√≠nia: "T√° matando uma crian√ßa a√≠ √©?" ????: "T√¥" Lav√≠nia: "A√≠ √© osso. Voc√™ prende e no processo ela fala e voc√™ perde a paci√™ncia" ????: "Arranquei a l√≠ngua primeiro"  üíÄ	tonho	
"A primeira coisa que eu fiz quando eu cheguei em casa foi um programa"	lavinia	
"Aqui √© s√≥ sombras, escurid√£o e m√∫sculos"	lalic	
"Pra mim, quanto maior melhor"	lalic	
"Sabe o que vc faz, quando a sala estiver silenciosa, vc pega um amigo ..."	lavinia	
"se ganhar eu dou o cu (ganhou)"	gabriel	
"Com calma e jeito chega-se ao cu de qualquer sujeito"	gabriel	
Gabriel: "Rolezin sexta bora?" ????: "Bora, mas eu vou na cama"	lalic	
"tem que matar mesmo, √© mo gostoso"	lavinia	
????: "eu boto eu boto eu boto" Antony: "vc bota??" ????: "eu boto!"	lalic	
"Na falta de nega√ß√£o teu cu no meu pauz√£o"	antony	
"Macetei no Rapaiz" 	lavinia	
" Voc√™ foi... (come√ßa a fazer beatbox) "	lalic	
"Pera a√≠, tava botando na boca de Gabriel"	lalic	
"falando em engasgar...hoje..."	lavinia	
"Uma Barbie Tchutcharia eu assistiria"	antony	
????: "Chupei at√© ficar roxo" Cabe√ßa: "Deve ser imposs√≠vel chupar at√© ficar roxo" ????: "Depende da sua determina√ß√£o"	antony	
"botaria uma bala na cabe√ßa se eu pudesse"	lavinia	
"Eu estou sem calcinha"	gabriel	
"eu aumentei a espessura e ficou menor?? ta certo isso?"	lalic	
"J√° fiz os medimentos (algu√©m tentando falar portugu√™s)"	lalic	
"Furtaram meu pau!"	gabriel	
"Vou botar uma placa de procura-se uma pomba"	gabriel	
"N√£o fodo, fa√ßo amor"	lavinia	
Lavinia: "eu n√£o boto palavras na boca de ningu√©m" ????: "vc bota outra coisa ne ?"	antony	
"Me deixou com vontade de JOGAR LOL... n√£o, mentira"	lalic	
"A impress√£o que da √© que vc morreu, mas ao mesmo tempo √© bom"	lavinia	
"Peito √© com sashi n√© comigo n√£o"	gabriel	
"N√£o √© loucura, vc s√≥ tem que saber fazer"	lavinia	
"Eu sou o rei das m√£es"	gigio	
"Tu t√° descansando entre os programas?"	gabriel	
"qual a cor da bund...do tenis"	gabriel	
"Vou perder a pica"	tonho	
"Lav√≠nia, ja bateu num saco de arroz?"	gabriel	
"Fui ver anime enquanto ela n√£o me respondia, slk terminei one piece"	antony	
"T√° ligado aquela paradinha azul vei? Eu tomei "	lavinia	
"Tem varios tipos de nude"	lavinia	
"Se Deus fez √© pq cabe"	antony	
"Repito, se alguem quiser me dar. Estou aceitando"	lavinia	
"Tiraram boku no hero da academia?"	lalic	
Gabriel: " eu to ouvindo barulhooo de conjura√ß√£o....." ????: "ahhhhh ta, achei que vc estava ouvindo o barulho de me comendo"	lavinia	
"Fui co√ßar o saco e apertei muito forte o ovo"	gabriel	
Arruda: "Lav√≠nia, como vc √©?" ????: "Loira do cabelo verde"	lalic	
Gabriel: "Diga nao as cobras" ????: "Depende, tem umas cobras que eu gosto"	lavinia	
Antony: "Gema n√£o" ????: "Mas t√° gostoso"	lalic	
"Eu lembrei do buraco de Gabriel"	arruda	
"Eu j√° cheirei muita coisa sabe"	arruda	
"Caralho... Broxei"	arruda	
"caralho, tem como lan√ßar foguete pelo discord agora √©?"	tonho	
"Como que √©?... Fortitude... Forteza... For√ßa"	lalic	
"Essa bolinha girando, √© um tes√£o"	antony	
????: "Gente, mamar o pr√≥prio pau √© auto aprecia√ß√£o ou viadagem?" Lavinia: "√â muita viadagem" ????: "Merda, sou um homem de necessidades"	gabriel	
"Galera galera, acho que fui picado por uma abelha... T√¥ com m√≥ rab√£o"	gabriel	
"Pode cadeirante na backrooms?"	lalic	
" Eu tava branco na pandemia, eu fiz transi√ß√£o racial "	cabe√ßa	
"O cara chega pra mim e fala vou te varar"	gabriel	
"Eu vou botar no de gabriel tambem"	lavinia	
"Eu quero que ele me d√™ o cu dele isso que eu quero"	gabriel	
"Eu preciso assistir  Wandinha e escutar Taylor Swift pra buceta vim"	gabriel	
"O bicho s√≥ pensa em furar porra, bota um buraco na parede"	antony	
"eu vou pedir pica ent√£o"	gabriel	
"o cara foi de ICarly"	antony	
"fui no mcdonalds e comprei um mcporra"	lalic	
"o cara me penetrou"	lalic	
Gabriel: "Claudionor ja trope√ßou no meu p√©" ????: "Vc ia fazer um favor pro INSS"	antony	
"Os caras sigma s√£o tipo heterotop que evolu√≠ram pra baixo. S√£o tipo heterotop sem o sertanejo"	gabriel	
" Nossa mano, teve uma que doeu minha garganta "	lalic	
"Vou ter que acertar o buraco de novo. Sou bom nisso. Acertei"	lalic	
"N√£o √© poss√≠vel que n√£o vai ter um caderninho no IFOOD"	lalic	
"√â t√£o bom atropelar motoqueiro... ... No gta tamb√©m"	lalic	
"Porra, vou ter que estacionar em lugar de aleijado"	lalic	
Lalic: "Pq todo mundo n√£o pega e se fode?" ????: "J√° fiz j√°"	tonho	
"(ganhou mvp na partida de vava) MEU DEUS QUE TESAAAAAAAAAO"	gabriel	
"Eu nunca comi um cu que aparece no instagram (cookie)"	lalic	
Homem das cavernas gay:" QUERO, CARALHO, WALTER WHITE "	lalic	
????: "Pra Lav√≠nia √© boa tarde, pro resto √© BOA TARDE PUTA" Lalic: "Tem duas aqui" ????: "BOA TARDES PUTA"	tonho	
"Enquanto voc√™ n√£o faz sexo, fa√ßa suco"	gabriel	
"T√° bom! Me foda"	lalic	
"ele te fez de bobo na casca da banana"	lalic	
"Vou jogar o caralho de noite"	lalic	
"A m√£e de Tonho foi pra Tonho?"	lalic	
"Eu me perco no movimento das m√£os dele"	antony	
"vou abrir os caras que caem"	gabriel	
" eu sou a comida "	lalic	
"deixa eu botar por cima do seu amigo ai, isso me bate vai"	gabriel	
"eu tava bem assim na cabe√ßa de tonho{em cima}"	gabriel	
" o meu passatempo √© socar egirl"	lalic	
"Eu fico muito incomodado quando eu to na academia e come√ßo a sentir cheiro de glicose"	gabriel	
"Ei minha boca parece um cuzinho olha"	gigio   
"Eu fico girando pra dormir. Sabe quando voc√™ t√° sentando..."	gabriel	
" agora fica ai dentro ne pica "	lalic   
"A pausada √© dura de vez em quando"	lalic	
"O que o Heats ta fazendo aqui hoje kid bengala nunca fez"	lalic	
" se a furia ganhar da loud, eu saio nu na rua"	gabriel	
"sera q eu vou ter q usar vpn pra ver essa pica?"	lalic	
"Que p√™nis gigantesco!"	lalic	
"dei"	gabriel	
"O que esse viado d√° de cu..."	antony	
"No balan√ßo da pica... Teu cu √© v√≠tima"	antony	
"Que susto caralho, o negocio de mateus cresceu"	lalic	
" To queimando.... Que isso? Eu nao paro de queimar!!! "	lalic	
" amizade √© o caralho "	gabriel	
Sofia: " Pq vc n√£o vai tomar no seu cu" ????: " Pior que eu vou fazer isso mesmo "	antony	
"Meu bon√© tem chap√©u"	lalic	
"Deveria ter cabeleireiro de pica"	gigio	
Gabriel: "Voce sabe oq √© H√≠men ne?" ????: "Sei, instituto de matem√°tica e estat√≠stica"	lalic	
"Se vc apertar o nariz do argentino sai √© p√≥"	antony	
"Fui sentar com for√ßa e rasguei o short"	gigio	
"Tem uma jaqueta foda... Casaco com gordo"	lalic	
"Pra vc estar de pau mole hj, alguem teve que ficar de pau duro"	gabriel	
"Isso a√≠ √© pra fazer antes de dormir, botar de lado..."	lalic	
"Eu s√≥ sei gemer bem alto, bem gostosinho"	gigio	
"Porra minha bunda t√° doendo por causa dessa PICA... ... dessa cadeira"	lalic	
Gabriel: "Ta moh climinha gostoso aqui" ????: "Pois √© viado, ta mo clima de fornica√ß√£o hj aqui"	lalic	
Tonho: "E o que voc√™ comia na casa da sua m√£e?" ????: "Porra!"	lalic	
"A vontade de colocar um black cock na minha boca agr"	lalic	
"Queria um monster cock na minha boca"	gabriel	
"N√£o venha com viado pra cima de mim n√£o"	lalic	
"Ele vai gozar, gg vei"	lalic	
"Meu Deus! Eu tava encostando no pau"	lalic	
"FICO COM HOMEM, SOU MACHO"	lalic	
"Tive que botar o casaco pq tava calor, ai agora ta um calor do cabrunco. Oh nao, tive que botar o casaco pq tava calor. PORRA"	lalic	
"Ent√£o... Calculando a √°rea do meu pau... Vai ser X calculando a cabe√ßa do meu pau"	lalic	
"O que eu digo √© aquilo que eu falo"	lalic	
"Viado, voc√™ acabou de entrar no seu cu"	lalic	
"Que buceta azul enorme" 	lalic	
"Aqui ta mais peniano, mais sexual"	lalic	
"Eu como ele tantas vezes, e todas as vezes √© orgasmico de bom"	lalic	
"Com aquela cal√ßa apertada, romulo deve ter uns 4 ovo j√°, dividiu certeza"	gabriel	
"Eu amo comer o rei, ele vem todo molhadinho todo gostosinho"	lalic	
"Lute como se voc√™ fosse o terceiro macaco na rampa da arca de noe e irm√£o esta come√ßando a chover"	casemiro	
"Agachi xi xi uoua"	lalic	
"Essa sabrina aqui t√° gostosa (sabrina do pokemon)"	lalic	
"J√° to pensando na hora que ele vai t√° aqui na minha frente todo gostoso"	lalic	
"Aff, n√£o me enche de porra"	lalic	